{
  "level": 1,
  "state": {
    "x": 0,
    "y": 0,
    "energy": 30,
    "keys": [],
    "map": [
        ["S", ".", ".", ".", ".", ".", "."],
        [".", "#", "#", "#", "#", "#", "."],
        [".", ".", "#", ".", -5 , ".", "."],
        [".", -9 , "A", "E", "#", "#", "."],
        [".", ".", "#", ".", "#", ".", "."],
        [".", "a", "#", ".", ".", ".", "#"],
        ["#", "#", "#", "#", "#", "#", "#"]
    ]
  }
}