{
  "level": 2,
  "state": {
    "x": 0,
    "y": 0,
    "energy": 25,
    "keys": [],
    "map": [
        ["S", ".", ".", ".", ".", ".", "."],
        [-5 , "#", "#", "#", "#", "#", "."],
        ["a", "#", ".", ".", ".", ".", "."],
        ["#", ".", ".", "#", "#", "#", "A"],
        ["a", ".", "#", ".", "B", ".",  8 ],
        ["b", ".", ".", ".", "#", ".", "E"],
        ["#", "#", "#", "#", "#", "#", "#"]
    ]
  }
}